Maze Name: Beginner Maze
Map Length: 20
Map Height: 10

╔═╦═════╦═╦══╦═════╗
║☺║   ║ ║ ║  ║     ║
║ ║ ║ ║   ║ ╔╣  ║ ═╣
║ ║ ║ ║ ║ ║ ╚╩═ ║  ║
║ ║ ║ ║ ║       ║  ║
║ ║ ║ ║ ╚═╦═════╝  ║
║   ║ ║   ║        ║
║ ══╩═╩══ ╚═╦═ ════╣
║           ║     X║
╚═══════════╩══════╝